

NO ./textures/wall_1.xpm


SO ./textures/wall_2.xpm

WE ./textures/wall_3.xpm

EA ./textures/brick.xpm

F 160,82,45


C 135,206,235

   11111111111
   1N000000001
   10000000001
   11111111111
