
          NO                ./textures/bleu-marine.xpm

               SO                   ./textures/jungle-exotique.xpm


EA              ./textures/salon.xpm
WE         ./textures/beautiful_blue.xpm

C      18,      255,200
F    14,122,122

          11111111111111111     111111111111
          10000000000000001     100000000001     1
          10000000000000001     100000S00001     1
          10000000000000001     100000000001     1
          10000000000000001     100000P00001     1
          10000000000000001     111111111111     1
          10000000000000001
          10000000000000001
          10000000000000001
          10000000000000001
          10000000000000001
          10000000000000001
          10000000000000001
          10000000000000001
          10000000000000001
          11111111111111111
